!!!!!!!!!!!!!!!!!!!!!!!!!!!!!!!!!!!!!!!!!!!!!!!!!!!!!!!!!!!!!!!!!!!!!!!!!!!!!!!!!!!!!!!!!!!!!!!!!!!!!!!!!!!!!!!!!!!!!!!!!!!!!!!!!!!!!!!!!
!#############################.#####################################.#####################################.#############################!
!#..........................##.##.......###################.......##.##.......###################.......##.##..........................#!
!#.#####.##.######.##.#####.##.##.##.##........##...........##.##.##.##.##.##...........##........##.##.##.##.#####.##.######.##.#####.#!
!#.#####.##.######.##.#####.##.##.##.##.######.##.#######.####.##.##.##.##.####.#######.##.######.##.##.##.##.#####.##.######.##.#####.#!
!#....##.##.######.##....##.##....##.##........##.#######.####.##.......##.####.#######.##........##.##....##.##....##.######.##.##....#!
!#.##.##.##........##.##.##.##.#####....######............#....###########....#............######....#####.##.##.##.##........##.##.##.#!
!#.##.##.##.######.##.##.##....#####.##.######.#######.####.##.###########.##.####.#######.######.##.#####....##.##.##.######.##.##.##.#!
!#.##.##.##.######.##.##.##.##....##.##.....##.##...........##.............##...........##.##.....##.##....##.##.##.##.######.##.##.##.#!
!#.##....##...##...##.##....##.##.##.######.##.##.##.####.#####################.####.##.##.##.######.##.##.##....##.##...##...##....##.#!
!#.#####.####.##.####.#####.##.##.##.######.##.##.##.####.#####################.####.##.##.##.######.##.##.##.#####.####.##.####.#####.#!
!#.#####.####.##.####.#####.##.##.##.##........##.##.................................##.##........##.##.##.##.#####.####.##.####.#####.#!
!#..........................##.##....##.#########.##.#####.#########.#########.#####.##.#########.##....##.##..........................#!
!###.##.######.##.###.##.#####.#####..............##.#####.....................#####.##..............#####.#####.##.###.##.######.##.###!
!###.##.######.##.###.##.#####.#####.##.############.##.##..####---------####..##.##.############.##.#####.#####.##.###.##.######.##.###!
!....##...##...##.....##.............##..............##.##..##!!!!!!!!!!!!!##..##.##..............##.............##.....##...##...##....!
!########.##.########.##.###########.##.############........##!!!!!!!!!!!!!##........############.##.###########.##.########.##.########!
!########.##.########.##.###########.##.############........##!!!!!!!!!!!!!##........############.##.###########.##.########.##.########!
!....##...##...##.....##.............##..............##.##..##!!!!!!!!!!!!!##..##.##..............##.............##.....##...##...##....!
!###.##.######.##.###.##.#####.#####.##.############.##.##..####---------####..##.##.############.##.#####.#####.##.###.##.######.##.###!
!###.##.######.##.###.##.#####.#####..............##.#####.....................#####.##..............#####.#####.##.###.##.######.##.###!
!#..........................##.##....##.#########.##.#####.#########.#########.#####.##.#########.##....##.##..........................#!
!#.#####.####.##.####.#####.##.##.##.##........##.##.................................##.##........##.##.##.##.#####.####.##.####.#####.#!
!#.#####.####.##.####.#####.##.##.##.######.##.##.##.####.#####################.####.##.##.##.######.##.##.##.#####.####.##.####.#####.#!
!#.##....##...##...##.##....##.##.##.######.##.##.##.####.#####################.####.##.##.##.######.##.##.##....##.##...##...##....##.#!
!#.##.##.##.######.##.##.##.##....##.##.....##.##...........##.............##...........##.##.....##.##....##.##.##.##.######.##.##.##.#!
!#.##.##.##.######.##.##.##....#####.##.######.#######.####.##.###########.##.####.#######.######.##.#####....##.##.##.######.##.##.##.#!
!#.##.##.##........##.##.##.##.#####....######............#....###########....#............######....#####.##.##.##.##........##.##.##.#!
!#....##.##.######.##....##.##....##.##........##.#######.####.##.......##.####.#######.##........##.##....##.##....##.######.##.##....#!
!#.#####.##.######.##.#####.##.##.##.##.######.##.#######.####.##.##.##.##.####.#######.##.######.##.##.##.##.#####.##.######.##.#####.#!
!#.#####.##.######.##.#####.##.##.##.##........##...........##.##.##.##.##.##...........##........##.##.##.##.#####.##.######.##.#####.#!
!#..........................##.##.......###################.......##.##.......###################.......##.##..........................#!
!#############################.#####################################.#####################################.#############################!
!!!!!!!!!!!!!!!!!!!!!!!!!!!!!!!!!!!!!!!!!!!!!!!!!!!!!!!!!!!!!!!!!!!!!!!!!!!!!!!!!!!!!!!!!!!!!!!!!!!!!!!!!!!!!!!!!!!!!!!!!!!!!!!!!!!!!!!!!