!!!!!!!!!!!!!!!!!!!!!!!!!!!!!!!!!!!!!!!!!!!!!!!!!!!!!!!!!!!!!!!!!!!
!################################.################################!
!#..............................#.#..............................#!
!#.####.#######.#########.#####.#.#.#####.#########.#######.####.#!
!#.#!!#.#!!!!!#.#!!!!!!!#.#!!!#.#.#.#!!!#.#!!!!!!!#.#!!!!!#.#!!#.#!
!#.####.#######.#########.#####.#.#.#####.#########.#######.####.#!
!#...............................................................#!
!#.#####.##########.#######.###########.#######.##########.#####.#!
!#.#!!!#.#!!!!!!!!#.#!!!!!#.#!!!!!!!!!#.#!!!!!#.#!!!!!!!!#.#!!!#.#!
!#.#####.##########.#######.###########.#######.##########.#####.#!
!#...............................................................#!
!#.#######.##########.######.#########.######.##########.#######.#!
!#.#................#.#!!!!#...........#!!!!#.#................#.#!
!#.#.####.#######.#.#.#!!!!#.#########.#!!!!#.#.#.#######.####.#.#!
!#.#.#....#.......#.#.######.#!!!!!!!#.######.#.#.......#....#.#.#!
!#.#.#.####.#######.#........#!!!!!!!#........#.#######.####.#.#.#!
!#..................########.#!!!!!!!#.########..................#!
!#######.##########..........#########..........##########.#######!
!!!!!!!#............#.######...........######.#............#!!!!!!!
!#######.####.#.#####........###---###........#####.#.####.#######!
!........#!!#.#.#!!!#.######.#!!!!!!!#.######.#!!!#.#.#!!#........!
!#######.####.#.#####........###---###........#####.#.####.#######!
!!!!!!!#............#.######...........######.#............#!!!!!!!
!#######.##########..........#########..........##########.#######!
!#..................########.#!!!!!!!#.########..................#!
!#.#.#.####.#######.#........#!!!!!!!#........#.#######.####.#.#.#!
!#.#.#....#.......#.#.######.#!!!!!!!#.######.#.#.......#....#.#.#!
!#.#.####.#######.#.#.#!!!!#.#########.#!!!!#.#.#.#######.####.#.#!
!#.#................#.#!!!!#...........#!!!!#.#................#.#!
!#.#######.##########.######.#########.######.##########.#######.#!
!#...............................................................#!
!#.#####.##########.#######.###########.#######.##########.#####.#!
!#.#!!!#.#!!!!!!!!#.#!!!!!#.#!!!!!!!!!#.#!!!!!#.#!!!!!!!!#.#!!!#.#!
!#.#####.##########.#######.###########.#######.##########.#####.#!
!#...............................................................#!
!#.####.#######.#########.#####.#.#.#####.#########.#######.####.#!
!#.#!!#.#!!!!!#.#!!!!!!!#.#!!!#.#.#.#!!!#.#!!!!!!!#.#!!!!!#.#!!#.#!
!#.####.#######.#########.#####.#.#.#####.#########.#######.####.#!
!#..............................#.#..............................#!
!################################.################################!
!!!!!!!!!!!!!!!!!!!!!!!!!!!!!!!!!!!!!!!!!!!!!!!!!!!!!!!!!!!!!!!!!!!