!!!!!!!!!!!!!!!!!!!!!!!!!!!!!
!#############.#############!
!#.........................#!
!#.#######.###.###.#######.#!
!#.#.....................#.#!
!#.#.######.##.##.######.#.#!
!#.#.#.................#.#.#!
!#.#.#.###############.#.#.#!
!#.#..........#..........#.#!
!#.#.#####.##.#.##.#####.#.#!
!#.........................#!
!#######.##.##.##.##.#######!
!!!!!!!#.............#!!!!!!!
!!!!!!!#.#####.#####.#!!!!!!!
!!!!!!!#.............#!!!!!!!
!#######.####---####.#######!
!........#!!!!!!!!!#........!
!#######.###########.#######!
!!!!!!!#.............#!!!!!!!
!!!!!!!#.#####.#####.#!!!!!!!
!!!!!!!#.............#!!!!!!!
!#######.##.##.##.##.#######!
!#.........................#!
!#.#.#####.##.#.##.#####.#.#!
!#.#..........#..........#.#!
!#.#.#.###############.#.#.#!
!#.#.#.................#.#.#!
!#.#.######.##.##.######.#.#!
!#.#.....................#.#!
!#.######.####.####.######.#!
!#.........................#!
!#############.#############!
!!!!!!!!!!!!!!!!!!!!!!!!!!!!!
